 # US States from postal codes
 AL => alabama
 AK => alaska
 AS => american samoa
 AZ => arizona
 AR => arkansas
 CA => california
 CO => colorado
 CT => connecticut
 DE => delaware
 DC => dist of columbia
 FL => florida
 GA => georgia
 GU => guam
 HI => hawaii
 ID => idaho
 IL => illinois
 IN => indiana
 IA => iowa
 KS => kansas
 KY => kentucky
 LA => louisiana
 ME => maine
 MD => maryland
 MH => marshall islands
 MA => massachusetts
 MI => michigan
 FM => micronesia
 MN => minnesota
 MS => mississippi
 MO => missouri
 MT => montana
 NE => nebraska
 NV => nevada
 NH => new hampshire
 NJ => new jersey
 NM => new mexico
 NY => new york
 NC => north carolina
 ND => north dakota
 MP => northern marianas
 OH => ohio
 OK => oklahoma
 OR => oregon
 PW => palau
 PA => pennsylvania
 PR => puerto rico
 RI => rhode island
 SC => south carolina
 SD => south dakota
 TN => tennessee
 TX => texas
 UT => utah
 VT => vermont
 VA => virginia
 VI => virgin islands
 WA => washington
 WV => west virginia
 WI => wisconsin
 WY => wyoming
